Amy's Cafe	(no specials today)							
Blue Velvet	(no specials today)							
Brocach Irish Pub	All Day Special:	Rehorst gin and vodka $4 mixers $6 martinis	Happy Hour Specials: (3-6pm and 10-close)	$6.50 pint of Guinness and shot of Powers	$4.25 pint Murphy's Stout	$5 glass of wine	1/2 off whiskey and scotch ($7-$12)	$5 Stoli Doli martinis
Brother's	$2 Jager and Cherry bombs	$3 Three Olives mixers	$4 Three Olives-Red bull vodkas	$3.25 domestic bottles				
Chaser's	Cheap pitchers (3-9pm)	Wheel n Deal night						
Church Key	Specials from 9pm to close:	$2.50 shots (bartender's choice)	$3 Smirnoff mixers and Long Islands	$3.50 Seagrams 7	$4 Captain			
The City	$4 PBR pitchers (3pm-9pm)	$3 rails	$4 Skyyscrapers (the blue one)	$4 Highrises (the red one)				
Echo Tap	Hors Doeuvres specials							
Essen Haus	$7.50 Beer Bongs ($5 refills)	$8.50 mixer Bongs (7.50 refills)						
Frida's	3-6pm: $2 Mexican bottles of beer							
The Great Dane	Happy Hour 4-6pm	Student ID special 9pm-close						
Hawk's	$6 bomb bottles							
Ivory Room	$3 Sweet Tea vodka and lemonades	$5 sangria/$15 sangria pitchers	$3.50 Capital Oktoberfest					
Johnny O's	$2.50 SoCo Lime shots	$3.50 Captain mixers	$6 Leinies pitcher					
Jordan's Big Ten	2 for 1 Bud Light taps	2 for 1 Long Islands 	$3 martini of the week	Friday fish fry				
Kollege Klub	$4 Jumbo Long Islands	$4 Stoli mixers	$4 Jack mixers					
Lava Lounge	$3 Long Islands	$2 PBR bottles	$2.50 SoCo Lime shots					
The Library	$3.25 Long Islands (4pm-close)	$2 Tall Boys (9pm-close)	$8 Spotted Cow pitchers (4-7pm)					
Logan's	$2 domestic pints (4-9pm)	$2 rail mixers (4-9pm)	$3 burger (a la carte)	$2 select shots	2 for 1 jello shots	$1 cheese pizzas		
Lucky's	$3 Bacardi mixers	$2 Doctor shots						
Madhatter's	$4 Double Three Olives mixers							
Madison's	(no specials today)							
Monday's	$1 taps till 10pm							
Nitty Gritty	Power Hour (10pm-11pm):	$1.25 rail mixers	$1 Michelob Golden Light taps	$2 Drop shots	Daily Specials (9pm-close):	2 for 1 Bud Light bottles and pints	$4 Jumbo Long Islands	
The Old Fashioned	Beer of the month special							
Paul's Club	$2 PBR cans	$3 Tully shots	$4.50 Brawndo bombs	$3.50 Southern Tier 2x IPA				
The Plaza	$2.50 rail mixers							
Red Shed	$7 JUMBO Long Islands							
Regent Street Retreat	Pool Tourney @ 7:30pm	$3 Bacardi mixers	$3 jager bombs	$2 High Life bottles				
Stadium Bar	$3 Captain mixers							
State Street Brats	$4 Jameson, Bacardi, Absolut doubles							
Tiki Shack	2 for 1 Rum Punches							
The Vintage	$1 off Vintage Brewing Co Beer (8pm-close)							
Wando's	$6 jumbo 42 Below mixers	$2.50 Icehole shots						
Whiskey River	(no specials today)							
Woof's	$1 off shots 8pm-midnight	1/2 off 4-7pm						
