Amy's Cafe	(no specials today)							
Blue Velvet	(no specials today)							
Brocach Irish Pub	All Day Special:	Rehorst gin and vodka $4 mixers $6 martinis	Happy Hour Specials: (3-6pm and 10-close)	$6.50 pint of Guinness and shot of Powers	$4.25 pint Murphy's Stout	$5 glass of wine	1/2 off whiskey and scotch ($7-$12)	$5 Stoli Doli martinis
Brother's	$2 Jager and Cherry bombs	$3 Bacardi mixers	$3.25 domestic bottles	$3.75 vodka-Red Bulls				
Chaser's	Specials from open-9pm:	$6 Goose Island pitchers	$5 Jumbo Screwdrivers and Bloody Marys	Specials from 9pm-close:	buy-a-shot-get-a-beer	$3 Tall Boys		
Church Key	Specials from 9pm to close:	$3 Bud Light pint and House shot	$3 Long Islands	$3 Svedka	$3.50 Bacardi	$4 Jack Daniels		
The City	$3 rails	$4 Skyyscrapers (the blue one)	$4 Highrises (the red one)					
Echo Tap	$1.25 High Life and PBR taps	$3 Captain and coke						
Essen Haus	$1 Wunder shots							
Frida's	(no specials today)							
The Great Dane	(no specials today)							
Hawk's	$6 bomb bottles							
Ivory Room	$3 Sweet Tea vodka and lemonades	$5 sangria/$15 sangria pitchers	$3.50 Capital Oktoberfest					
Johnny O's	$3 Pinnacle vodka mixers	$3 rail vodka mixers	$6 pitchers of Leinies					
Jordan's Big Ten	$5 Bud Light pitchers	$5 redbull pints	$5 bucket of 6 domestic shorties	$5 bucket of 5 import shorties				
Kollege Klub	$4 Jumbo Long Islands	$4 Stoli mixers	$4 Jack mixers					
Lava Lounge	$4 tall Jack mixers	$2 Bud Light bottles						
The Library	$3 Jack mixers (7pm-close)	$2.50 Tall Boys (7pm-close)						
Logan's	$1 cheese pizzas							
Lucky's	$2 pie shots	$10 microbrew pitchers	$3 Captain Lime bite-a-ritas					
Madhatter's	$4 Double Three Olives mixers							
Madison's	(no specials today)							
Monday's	(no specials today)							
Nitty Gritty	Power Hour (10pm-11pm):	$1.25 rail mixers	$1 Michelob Golden Light taps	$2 Drop shots	Daily Specials (9pm-close):	$3.50 Bud Light bottles	$4 Jumbo Smirnoff mixers	$3.50 Miller Lite bottles
The Old Fashioned	Beer of the month special							
Paul's Club	$2 PBR cans	$3 Tully shots	$4.50 Brawndo bombs	$3.50 Southern Tier 2x IPA				
The Plaza	$2.50 domestic bottles							
Red Shed	$7 JUMBO Long Islands							
Regent Street Retreat	$3 Three Olive mixers	$3 Monster mixers	$10 all-you-can-drink (10pm-midnight)					
Stadium Bar	$2 vodka mixers							
State Street Brats	$4 Skyy doubles, Rosebowls, Long Islands							
Tiki Shack	2 for 1 Bahama Mamas							
The Vintage	Bloody Mary Bar (9am-noon)	$1 off Vintage Brewing beer (8pm-close)						
Wando's	$6 jumbo 42 Below mixers							
Whiskey River	(no specials today)							
Woof's	1/2 off 4-7pm							
